11111111111111111111111111111
1000000000C00000C000000000001
10001111111000001111111111001
1000000000P00C111111111111001
10001111111000000C11111111001
11111111111111100001000000001
1111111111111110C001011111001
11111111111111100001011111001
10000000111111100001011111001
10011100000000000001011111001
10011100000000000001000000001
1001111011111111111100000E001
11111111111111111111111111111