111111111111111111111111111111
1P000e000000000000000000000e01
101011111111111111111111111101
10001111111C111111111111111101
1111111111101100001111111eE101
111111100000000C10001000001101
10000e100C11111111101100e01101
101110001111111111101101011101
101111111C00000e11101100011101
10111C000011011011101101111101
1011111110000110111000C1111101
101111111111111C11111111111101
100000000000000000000000000001
111111111111111111111111111111