11111111111111111111111
10000000000000000000001
1C1000000P00C0000000001
11100000000C10100000001
1000000000001E100000001
10000000000011100000001
11111111111111111111111